Accessibility settings
AccessibilityShortcutsEnabled	Enable accessibility features shortcuts
AutoclickEnabled	Enable the autoclick accessibility feature
CaretHighlightEnabled	Enable the caret highlight accessibility feature
ColorCorrectionEnabled	Enable the color correction accessibility feature
CursorHighlightEnabled	Enable the cursor highlight accessibility feature
DeviceLoginScreenAccessibilityShortcutsEnabled	Enable accessibility features shortcuts on the login screen
DeviceLoginScreenAutoclickEnabled	Enable autoclick on the login screen
DeviceLoginScreenCaretHighlightEnabled	Enable caret highlight on the login screen
DeviceLoginScreenCursorHighlightEnabled	Enable the cursor highlight on the login screen
DeviceLoginScreenDefaultHighContrastEnabled	Set the default state of high contrast mode on the login screen
DeviceLoginScreenDefaultLargeCursorEnabled	Set default state of the large cursor on the login screen
DeviceLoginScreenDefaultScreenMagnifierType	Set the default screen magnifier type enabled on the login screen
DeviceLoginScreenDefaultSpokenFeedbackEnabled	Set the default state of spoken feedback on the login screen
DeviceLoginScreenDefaultVirtualKeyboardEnabled	Set default state of the on-screen keyboard on the login screen
DeviceLoginScreenDictationEnabled	Enable the dictation on the login screen
DeviceLoginScreenFaceGazeEnabled	Enable face control on the login screen
DeviceLoginScreenHighContrastEnabled	Enable the high contrast on the login screen
DeviceLoginScreenKeyboardFocusHighlightEnabled	Enable the keyboard focus highlighting accessibility feature
DeviceLoginScreenLargeCursorEnabled	Enable the large cursor on the login screen
DeviceLoginScreenMonoAudioEnabled	Enable mono audio on the login screen
DeviceLoginScreenScreenMagnifierType	Set the screen magnifier type on the login screen
DeviceLoginScreenSelectToSpeakEnabled	Enable the select to speak on the login screen
DeviceLoginScreenShowOptionsInSystemTrayMenu	Show accessibility options in system tray menu in the login screen
DeviceLoginScreenSpokenFeedbackEnabled	Enable the spoken feedback on the login screen
DeviceLoginScreenStickyKeysEnabled	Enable sticky keys on the login screen
DeviceLoginScreenVirtualKeyboardEnabled	Enable the accessibility virtual keyboard on the login screen
DictationEnabled	Enable the dictation accessibility feature
EnhancedNetworkVoicesInSelectToSpeakAllowed	Allow the enhanced network text-to-speech voices in Select-to-speak
FaceGazeEnabled	Enable the face control accessibility feature
FloatingAccessibilityMenuEnabled	Enables the floating accessibility menu
HighContrastEnabled	Enable high contrast mode
KeyboardDefaultToFunctionKeys	Media keys default to function keys
KeyboardFocusHighlightEnabled	Enable the keyboard focus highlighting accessibility feature
LargeCursorEnabled	Enable large cursor
LiveCaptionEnabled	Enable Live Caption
LiveTranslateEnabled	Enable Live Translate
MonoAudioEnabled	Enable the mono audio accessibility feature
ScreenMagnifierType	Set screen magnifier type
SelectToSpeakEnabled	Enable select to speak
ShowAccessibilityOptionsInSystemTrayMenu	Show accessibility options in system tray menu
SpokenFeedbackEnabled	Enable spoken feedback
StickyKeysEnabled	Enable sticky keys
UiAutomationProviderEnabled	Enable the browser's UI Automation accessibility framework provider on Windows
VirtualKeyboardEnabled	Enable the accessibility virtual keyboard
VirtualKeyboardFeatures	Enable or disable various features on the on-screen keyboard
Allow or deny screen capture
MultiScreenCaptureAllowedForUrls	Enables automatic screencapture of multiple screens
SameOriginTabCaptureAllowedByOrigins	Allow Same Origin Tab capture by these origins
ScreenCaptureAllowed	Allow or deny screen capture
ScreenCaptureAllowedByOrigins	Allow Desktop, Window, and Tab capture by these origins
TabCaptureAllowedByOrigins	Allow Tab capture by these origins
WindowCaptureAllowedByOrigins	Allow Window and Tab capture by these origins
Android settings
ArcAppInstallEventLoggingEnabled	Log events for Android app installs
ArcAppToWebAppSharingEnabled	Enable sharing from Android apps to Web apps
ArcBackupRestoreServiceEnabled	Control Android backup and restore service
ArcCertificatesSyncMode	Set certificate availability for ARC-apps
ArcEnabled	Enable ARC
ArcGoogleLocationServicesEnabled	Control Android Google location services
ArcOpenLinksInBrowserByDefault	Open links in Chrome browser by default
ArcPolicy	Configure ARC
DeviceFlexArcPreloadEnabled	Preload ArcVM image On Flex
UnaffiliatedArcAllowed	Allow unaffiliated users to use ARC
UnaffiliatedDeviceArcAllowed	Allow enterprise users to use ARC on unaffiliated devices.
Borealis
UserBorealisAllowed	Allow users to use Borealis on Google ChromeOS
Certificate management settings
CACertificateManagementAllowed	Allow users to manage installed CA certificates.
CACertificates	TLS certificates that should be trusted by Google Chrome for server authentication
CACertificatesWithConstraints	TLS certificates that should be trusted by Google Chrome for server authentication with constraints
CADistrustedCertificates	TLS certificates that should be distrusted by Google Chrome for server authentication
CAHintCertificates	TLS certificates that are not trusted or distrusted but can be used in path-building for server authentication
CAPlatformIntegrationEnabled	Use user-added TLS certificates from platform trust stores for server authentication
RequiredClientCertificateForDevice	Required device-wide Client Certificates
RequiredClientCertificateForUser	Required Client Certificates
Class management tools Settings
ClassManagementCaptionsEnabled	Configure Class Tools caption feature
ClassManagementClassroomIntegrationEnabled	Configure Class Tools Google Classroom integration feature
ClassManagementEnabled	Configure Class Tools
ClassManagementNetworkRestrictionEnabled	Configure Class Tools network restriction
ClassManagementViewScreenEnabled	Configure Class Tools view screen feature
CloudUpload
GoogleWorkspaceCloudUpload	Configures the Cloud Upload flow for Google Drive and Google Workspace
MicrosoftOfficeCloudUpload	Configures the Cloud Upload flow for Microsoft OneDrive and Microsoft 365
Content settings
AutoSelectCertificateForUrls	Automatically select client certificates for these sites
AutomaticFullscreenAllowedForUrls	Allow automatic fullscreen on these sites
AutomaticFullscreenBlockedForUrls	Block automatic fullscreen on these sites
ClipboardAllowedForUrls	Allow clipboard on these sites
ClipboardBlockedForUrls	Block clipboard on these sites
ControlledFrameAllowedForUrls	Allow Controlled Frame API on these sites
ControlledFrameBlockedForUrls	Block Controlled Frame API on these sites
CookiesAllowedForUrls	Allow cookies on these sites
CookiesBlockedForUrls	Block cookies on these sites
CookiesSessionOnlyForUrls	Limit cookies from matching URLs to the current session
DataUrlInSvgUseEnabled	Data URL support for SVGUseElement.
DefaultClipboardSetting	Default clipboard setting
DefaultControlledFrameSetting	Control use of the Controlled Frame API
DefaultCookiesSetting	Default cookies setting
DefaultDeviceAttributesSetting	Control use of the Device Attributes API
DefaultDirectSocketsSetting	Control use of the Direct Sockets API
DefaultFileSystemReadGuardSetting	Control use of the File System API for reading
DefaultFileSystemWriteGuardSetting	Control use of the File System API for writing
DefaultGeolocationSetting	Default geolocation setting
DefaultImagesSetting	Default images setting
DefaultInsecureContentSetting	Control use of insecure content exceptions
DefaultJavaScriptJitSetting	Control use of JavaScript JIT
DefaultJavaScriptOptimizerSetting	Control use of JavaScript optimizers
DefaultJavaScriptSetting	Default JavaScript setting
DefaultLocalFontsSetting	Default Local Fonts permission setting
DefaultMediaStreamSetting	Default mediastream setting
DefaultNotificationsSetting	Default notification setting
DefaultPopupsSetting	Default pop-ups setting
DefaultSensorsSetting	Default sensors setting
DefaultSerialGuardSetting	Control use of the Serial API
DefaultThirdPartyStoragePartitioningSetting	Default third-party storage partitioning setting
DefaultWebBluetoothGuardSetting	Control use of the Web Bluetooth API
DefaultWebHidGuardSetting	Control use of the WebHID API
DefaultWebUsbGuardSetting	Control use of the WebUSB API
DefaultWindowManagementSetting	Default Window Management permission setting
DefaultWindowPlacementSetting	Default Window Placement permission setting
DeviceAttributesAllowedForOrigins	Allow Device Attributes API on these sites
DeviceAttributesBlockedForOrigins	Block Device Attributes API on these sites
DirectSocketsAllowedForUrls	Allow Direct Sockets API on these sites
DirectSocketsBlockedForUrls	Block Direct Sockets API on these sites
FileSystemReadAskForUrls	Allow read access via the File System API on these sites
FileSystemReadBlockedForUrls	Block read access via the File System API on these sites
FileSystemWriteAskForUrls	Allow write access to files and directories on these sites
FileSystemWriteBlockedForUrls	Block write access to files and directories on these sites
ImagesAllowedForUrls	Allow images on these sites
ImagesBlockedForUrls	Block images on these sites
InsecureContentAllowedForUrls	Allow insecure content on these sites
InsecureContentBlockedForUrls	Block insecure content on these sites
JavaScriptAllowedForUrls	Allow JavaScript on these sites
JavaScriptBlockedForUrls	Block JavaScript on these sites
JavaScriptJitAllowedForSites	Allow JavaScript to use JIT on these sites
JavaScriptJitBlockedForSites	Block JavaScript from using JIT on these sites
JavaScriptOptimizerAllowedForSites	Allow JavaScript optimization on these sites
JavaScriptOptimizerBlockedForSites	Block JavaScript optimizations on these sites
LocalFontsAllowedForUrls	Allow Local Fonts permission on these sites
LocalFontsBlockedForUrls	Block Local Fonts permission on these sites
NotificationsAllowedForUrls	Allow notifications on these sites
NotificationsBlockedForUrls	Block notifications on these sites
PartitionedBlobUrlUsage	Choose whether Blob URLs are partitioned during fetching and navigations
PdfLocalFileAccessAllowedForDomains	Allow local file access to file:// URLs on these sites in the PDF Viewer
PopupsAllowedForUrls	Allow pop-ups on these sites
PopupsBlockedForUrls	Block pop-ups on these sites
RegisteredProtocolHandlers	Register protocol handlers
SensorsAllowedForUrls	Allow access to sensors on these sites
SensorsBlockedForUrls	Block access to sensors on these sites
SerialAllowAllPortsForUrls	Automatically grant permission to sites to connect all serial ports.
SerialAllowUsbDevicesForUrls	Automatically grant permission to sites to connect to USB serial devices.
SerialAskForUrls	Allow the Serial API on these sites
SerialBlockedForUrls	Block the Serial API on these sites
ThirdPartyStoragePartitioningBlockedForOrigins	Disable third-party storage partitioning for specific top-level origins
WebHidAllowAllDevicesForUrls	Automatically grant permission to sites to connect to any HID device.
WebHidAllowDevicesForUrls	Automatically grant permission to these sites to connect to HID devices with the given vendor and product IDs.
WebHidAllowDevicesWithHidUsagesForUrls	Automatically grant permission to these sites to connect to HID devices containing top-level collections with the given HID usage.
WebHidAskForUrls	Allow the WebHID API on these sites
WebHidBlockedForUrls	Block the WebHID API on these sites
WebUsbAllowDevicesForUrls	Automatically grant permission to these sites to connect to USB devices with the given vendor and product IDs.
WebUsbAskForUrls	Allow WebUSB on these sites
WebUsbBlockedForUrls	Block WebUSB on these sites
WindowManagementAllowedForUrls	Allow Window Management permission on these sites
WindowManagementBlockedForUrls	Block Window Management permission on these sites
WindowPlacementAllowedForUrls	Allow Window Placement permission on these sites
WindowPlacementBlockedForUrls	Block Window Placement permission on these sites
Date and time
CalendarIntegrationEnabled	Enable Google Calendar Integration
SystemTimezone	Timezone
SystemTimezoneAutomaticDetection	Configure the automatic timezone detection method
SystemUse24HourClock	Use 24 hour clock by default
Default search provider
DefaultSearchProviderAlternateURLs	List of alternate URLs for the default search provider
DefaultSearchProviderEnabled	Enable the default search provider
DefaultSearchProviderEncodings	Default search provider encodings
DefaultSearchProviderImageURL	Parameter providing search-by-image feature for the default search provider
DefaultSearchProviderImageURLPostParams	Parameters for image URL which uses POST
DefaultSearchProviderKeyword	Default search provider keyword
DefaultSearchProviderName	Default search provider name
DefaultSearchProviderNewTabURL	Default search provider new tab page URL
DefaultSearchProviderSearchURL	Default search provider search URL
DefaultSearchProviderSearchURLPostParams	Parameters for search URL which uses POST
DefaultSearchProviderSuggestURL	Default search provider suggest URL
DefaultSearchProviderSuggestURLPostParams	Parameters for suggest URL which uses POST
Desk Connector Settings
DeskAPIThirdPartyAccessEnabled	Enable Desk API for third-party Google ChromeOS control
DeskAPIThirdPartyAllowlist	Enable Desk API for a list of third-party domains
Device update settings
ChromeOsReleaseChannel	Release channel
ChromeOsReleaseChannelDelegated	Users may configure the Google ChromeOS release channel
DeviceAutoUpdateDisabled	Disable Auto Update
DeviceAutoUpdateP2PEnabled	Auto update P2P enabled
DeviceAutoUpdateTimeRestrictions	Update Time Restrictions
DeviceExtendedAutoUpdateEnabled	Enable/disable Extended Automatic Updates
DeviceMinimumVersion	Configure minimum allowed Google ChromeOS version for the device.
DeviceMinimumVersionAueMessage	Configure auto update expiration message for DeviceMinimumVersion policy
DeviceQuickFixBuildToken	Provide users with Quick Fix Build
DeviceRollbackAllowedMilestones	Number of milestones kernel key increments are held back
DeviceRollbackToTargetVersion	Roll back OS to target version
DeviceTargetVersionPrefix	Target Auto Update Version
DeviceUpdateAllowedConnectionTypes	Connection types allowed for updates
DeviceUpdateHttpDownloadsEnabled	Allow autoupdate downloads via HTTP
DeviceUpdateScatterFactor	Auto update scatter factor
DeviceUpdateStagingSchedule	The staging schedule for applying a new update
RebootAfterUpdate	Automatically reboot after update
Display
DeviceDisplayResolution	Set display resolution and scale factor
DisplayRotationDefault	Set default display rotation, reapplied on every reboot
Drive
DriveDisabled	Disable Drive in the Google ChromeOS Files app
DriveDisabledOverCellular	Disable Google Drive over cellular connections in the Google ChromeOS Files app
DriveFileSyncAvailable	Google ChromeOS file sync
MicrosoftOneDriveAccountRestrictions	Restricts accounts that can use the Microsoft OneDrive integration
MicrosoftOneDriveMount	Configures the mounting of Microsoft OneDrive
EDU settings
ContentTransferEnablementStatus	Configure when the Google ChromeOS Content transfer tool is available
Extensions
BlockExternalExtensions	Blocks external extensions from being installed
ExtensionAllowedTypes	Configure allowed app/extension types
ExtensionDeveloperModeSettings	Control the availability of developer mode on extensions page
ExtensionExtendedBackgroundLifetimeForPortConnectionsToUrls	Configure a list of origins that grant extended background lifetime to the connecting extensions.
ExtensionForceInstallWithNonMalwareViolationsEnabled	Enable Force-installed Extensions With Non-Malware Violations
ExtensionInstallAllowlist	Configure extension installation allow list
ExtensionInstallBlocklist	Configure extension installation blocklist
ExtensionInstallForcelist	Configure the list of force-installed apps and extensions
ExtensionInstallSources	Configure extension, app, and user script install sources
ExtensionInstallTypeBlocklist	Blocklist for install types of extensions
ExtensionOAuthRedirectUrls	Configure additional OAuth redirect URLs per extension
ExtensionSettings	Extension management settings
ExtensionUnpublishedAvailability	Control availability of extensions unpublished on the Chrome Web Store.
MandatoryExtensionsForIncognitoNavigation	Extensions that have to be allowed to run in Incognito by the user in order to navigate in Incognito mode
First-Party Sets Settings
FirstPartySetsEnabled	Enable First-Party Sets.
FirstPartySetsOverrides	Override First-Party Sets.
Floating SSO Settings
AutoSignOutEnabled	Enable Automatic Sign-out Service
FloatingSsoDomainBlocklist	Floating SSO Service blocked domain list
FloatingSsoDomainBlocklistExceptions	Floating SSO Service domain blocklist exception list
FloatingSsoEnabled	Enable Floating SSO Service
Gaia user identity management settings
GaiaOfflineSigninTimeLimitDays	Limit the time for which a user authenticated via GAIA without SAML can log in offline
Generative AI
AIModeSettings	Settings for Google's AI Mode integrations in the address bar and New Tab page search box.
AutofillPredictionSettings	Settings for enhanced autofill
CreateThemesSettings	Settings for Create Themes with AI
DevToolsGenAiSettings	Settings for Chrome DevTools Generative AI Features
GeminiSettings	Settings for Gemini integration
GenAIInlineImageSettings	Settings for GenAI Inline Image feature
GenAILocalFoundationalModelSettings	Settings for GenAI local foundational model
GenAIPhotoEditingSettings	Settings for Generative AI Photo Editing feature
GenAISmartGroupingSettings	Settings for Suggested Groups
GenAIVcBackgroundSettings	Settings for Generative AI VC Background feature
GenAIWallpaperSettings	Settings for Generative AI Wallpaper feature
GenAiChromeOsSmartActionsSettings	Settings for the Text Capture feature
HelpMeReadSettings	Settings for Help Me Read feature
HelpMeWriteSettings	Settings for Help Me Write
HistorySearchSettings	Settings for AI-powered History Search
TabCompareSettings	Tab Compare settings
Google Cast
AccessCodeCastDeviceDuration	Specifies how long (in seconds) a cast device selected with an access code or QR code stays in the Google Cast menu's list of cast devices.
AccessCodeCastEnabled	Allow users to select cast devices with an access code or QR code from within the Google Cast menu.
EnableMediaRouter	Enable Google Cast
MediaRouterCastAllowAllIPs	Allow Google Cast to connect to Cast devices on all IP addresses.
ShowCastIconInToolbar	Show the Google Cast toolbar icon
ShowCastSessionsStartedByOtherDevices	Show media controls for Google Cast sessions started by other devices on the local network
HTTP authentication
AllHttpAuthSchemesAllowedForOrigins	List of origins allowing all HTTP authentication
AllowCrossOriginAuthPrompt	Cross-origin HTTP Authentication prompts
AuthAndroidNegotiateAccountType	Account type for HTTP Negotiate authentication
AuthNegotiateDelegateAllowlist	Kerberos delegation server allowlist
AuthNegotiateDelegateByKdcPolicy	Use KDC policy to delegate credentials.
AuthSchemes	Supported authentication schemes
AuthServerAllowlist	Authentication server allowlist
BasicAuthOverHttpEnabled	Allow Basic authentication for HTTP
DisableAuthNegotiateCnameLookup	Disable CNAME lookup when negotiating Kerberos authentication
EnableAuthNegotiatePort	Include non-standard port in Kerberos SPN
GSSAPILibraryName	GSSAPI library name
NtlmV2Enabled	Enable NTLMv2 authentication.
Idle Browser Actions
IdleTimeout	Delay before running idle actions
IdleTimeoutActions	Actions to run when the computer is idle
Kerberos
KerberosAccounts	Configure Kerberos accounts
KerberosAddAccountsAllowed	Users can add Kerberos accounts
KerberosCustomPrefilledConfig	Prefilled configuration for Kerberos tickets
KerberosDomainAutocomplete	Autocomplete domain for new Kerberos tickets
KerberosEnabled	Enable Kerberos functionality
KerberosRememberPasswordEnabled	Enable 'Remember password' feature for Kerberos
KerberosUseCustomPrefilledConfig	Change the prefilled configuration for Kerberos tickets
Kiosk settings
AllowKioskAppControlChromeVersion	Allow the auto launched with zero delay kiosk app to control Google ChromeOS version
DeviceLocalAccountAutoLoginBailoutEnabled	Enable bailout keyboard shortcut for auto-login
DeviceLocalAccountAutoLoginDelay	Device-local account auto-login timer
DeviceLocalAccountAutoLoginId	Device-local account for auto-login
DeviceLocalAccountPromptForNetworkWhenOffline	Enable network configuration prompt when offline
DeviceLocalAccounts	Device-local accounts
DeviceWeeklyScheduledSuspend	Schedule weekly suspend intervals
KioskActiveWiFiCredentialsScopeChangeEnabled	Expose per-app kiosk active WiFi credentials to the device level
KioskApplicationLogCollectionEnabled	Enable kiosk application log collection
KioskChromeAppsForceAllowed	Force Allow Chrome Apps in Kiosk mode
KioskTroubleshootingToolsEnabled	Enable Kiosk troubleshooting tools
KioskWebAppOfflineEnabled	Allow kiosk web app to show network prompt on app launch if the device is offline
NewWindowsInKioskAllowed	Allow Web Kiosk to open more than one browser window on any screen
Legacy Browser Support
AlternativeBrowserParameters	Command-line parameters for the alternative browser.
AlternativeBrowserPath	Alternative browser to launch for configured websites.
BrowserSwitcherChromeParameters	Command-line parameters for switching from the alternative browser.
BrowserSwitcherChromePath	Path to Chrome for switching from the alternative browser.
BrowserSwitcherDelay	Delay before launching alternative browser (milliseconds)
BrowserSwitcherEnabled	Enable the Legacy Browser Support feature.
BrowserSwitcherExternalGreylistUrl	URL of an XML file that contains URLs that should never trigger a browser switch.
BrowserSwitcherExternalSitelistUrl	URL of an XML file that contains URLs to load in an alternative browser.
BrowserSwitcherKeepLastChromeTab	Keep last tab open in Chrome.
BrowserSwitcherParsingMode	Sitelist parsing mode
BrowserSwitcherUrlGreylist	Websites that should never trigger a browser switch.
BrowserSwitcherUrlList	Websites to open in alternative browser
BrowserSwitcherUseIeSitelist	Use Internet Explorer's SiteList policy for Legacy Browser Support.
Linux container
CrostiniAllowed	User is enabled to run Crostini
CrostiniExportImportUIAllowed	User is enabled to export / import Crostini containers via the UI
CrostiniPortForwardingAllowed	Allow users to [enable/configure] Crostini port forwarding
DeviceUnaffiliatedCrostiniAllowed	Allow unaffiliated users to use Crostini
SystemTerminalSshAllowed	Allow SSH outgoing client connections in Terminal System App
VirtualMachinesAllowed	Allow devices to run virtual machines on ChromeOS
Local Network Access settings
LocalNetworkAccessAllowedForUrls	Allow sites to make requests to local network endpoints.
LocalNetworkAccessBlockedForUrls	Block sites from making requests to local network endpoints.
LocalNetworkAccessRestrictionsEnabled	Specifies whether to apply restrictions to requests to local network endpoints
LocalNetworkAccessRestrictionsTemporaryOptOut	Specifies whether to (temporarily) opt out of Local Network Access restrictions
Local user data storage
LocalUserFilesAllowed	Enable local user files
LocalUserFilesMigrationDestination	Local user files migration destination
Microsoft® Active Directory® management settings
CloudAPAuthEnabled	Allow automatic sign-in to Microsoft® cloud identity providers
AbusiveExperienceInterventionEnforce	Abusive Experience Intervention Enforce
AccessibilityImageLabelsEnabled	Enable Get Image Descriptions from Google.
AccessibilityPerformanceFilteringAllowed	Allow Accessibility Performance Filtering.
AdHocCodeSigningForPWAsEnabled	Native application signing during Progressive Web Application installation
AdditionalDnsQueryTypesEnabled	Allow DNS queries for additional DNS record types
AdsSettingForIntrusiveAdsSites	Ads setting for sites with intrusive ads
AdvancedProtectionAllowed	Enable additional protections for users enrolled in the Advanced Protection program
AllowBackForwardCacheForCacheControlNoStorePageEnabled	Allow pages with Cache-Control: no-store header to enter back/forward cache
AllowChromeDataInBackups	Allow backup of Google Chrome data
AllowDeletingBrowserHistory	Enable deleting browser and download history
AllowDinosaurEasterEgg	Allow Dinosaur Easter Egg Game
AllowExcludeDisplayInMirrorMode	Show a UI toggle to exclude a display in mirror mode.
AllowFileSelectionDialogs	Allow invocation of file selection dialogs
AllowScreenLock	Permit locking the screen
AllowSystemNotifications	Allows system notifications
AllowWebAuthnWithBrokenTlsCerts	Allow Web Authentication requests on sites with broken TLS certificates.
AllowedDomainsForApps	Define domains allowed to access Google Workspace
AllowedInputMethods	Configure the allowed input methods in a user session
AllowedInputMethodsForceEnabled	Enforce all allowed input methods to be enabled in a user session
AllowedLanguages	Configure the allowed languages in a user session
AlternateErrorPagesEnabled	Enable alternate error pages
AlwaysOnVpnPreConnectUrlAllowlist	Allow user browser access to a list of URLs while Always-on VPN is active in strict mode with lockdown enabled and the VPN is not connected
AlwaysOpenPdfExternally	Always Open PDF files externally
AmbientAuthenticationInPrivateModesEnabled	Enable Ambient Authentication for profile types.
AppLaunchAutomation	App Launch Automation
AppStoreRatingEnabled	Allows users to be shown the iOS App Store Rating promo
ApplicationBoundEncryptionEnabled	Enable Application Bound Encryption
ApplicationLocaleValue	Application locale
ArcVmDataMigrationStrategy	Migration strategy for ARC VM Data Migration
AudioCaptureAllowed	Allow or deny audio capture
AudioCaptureAllowedUrls	URLs that will be granted access to audio capture devices without prompt
AudioOutputAllowed	Allow playing audio
AudioProcessHighPriorityEnabled	Allow the audio process to run with priority above normal on Windows
AudioSandboxEnabled	Allow the audio sandbox to run
AutoFillEnabled	Enable AutoFill
AutoLaunchProtocolsFromOrigins	Define a list of protocols that can launch an external application from listed origins without prompting the user
AutoOpenAllowedForURLs	URLs where AutoOpenFileTypes can apply
AutoOpenFileTypes	List of file types that should be automatically opened on download
AutofillAddressEnabled	Enable AutoFill for addresses
AutofillCreditCardEnabled	Enable AutoFill for credit cards
AutoplayAllowed	Allow media autoplay
AutoplayAllowlist	Allow media autoplay on a allowlist of URL patterns
BackForwardCacheEnabled	Control the BackForwardCache feature.
BackgroundModeEnabled	Continue running background apps when Google Chrome is closed
BatterySaverModeAvailability	Enable Battery Saver Mode
BlockThirdPartyCookies	Block third party cookies
BookmarkBarEnabled	Enable Bookmark Bar
BrowserAddPersonEnabled	Enable add person in user manager
BrowserGuestModeEnabled	Enable guest mode in browser
BrowserGuestModeEnforced	Enforce browser guest mode
BrowserLabsEnabled	Browser experiments icon in toolbar
BrowserLegacyExtensionPointsBlocked	Block Browser Legacy Extension Points
BrowserNetworkTimeQueriesEnabled	Allow queries to a Google time service
BrowserSignin	Browser sign in settings
BrowserThemeColor	Configure the color of the browser's theme
BrowsingDataLifetime	Browsing Data Lifetime Settings
BuiltInAIAPIsEnabled	Allow pages to use the built-in AI APIs.
BuiltInDnsClientEnabled	Use built-in DNS client
CORSNonWildcardRequestHeadersSupport	CORS non-wildcard request headers support
CaptivePortalAuthenticationIgnoresProxy	Captive portal authentication ignores proxy
CertificateTransparencyEnforcementDisabledForCas	Disable Certificate Transparency enforcement for a list of subjectPublicKeyInfo hashes
CertificateTransparencyEnforcementDisabledForUrls	Disable Certificate Transparency enforcement for a list of URLs
ChromeForTestingAllowed	Allow Chrome for Testing
ChromeOsLockOnIdleSuspend	Enable lock when the device suspends or the lid is closed
ChromeOsMultiProfileUserBehavior	Control the user behavior in a multiprofile session
ChromeVariations	Determine the availability of variations
ClearBrowsingDataOnExitList	Clear Browsing Data on Exit
ClickToCallEnabled	Enable the Click to Call Feature
ClientCertificateManagementAllowed	Allow users to manage installed client certificates.
CloudManagementEnrollmentMandatory	Enable mandatory cloud management enrollment
CloudManagementEnrollmentToken	The enrollment token of cloud policy
CloudPolicyOverridesPlatformPolicy	Google Chrome cloud policy overrides Platform policy.
CloudUserPolicyMerge	Enables merging of user cloud policies into machine-level policies
CloudUserPolicyOverridesCloudMachinePolicy	Allow user cloud policies to override Chrome Browser Cloud Management policies.
CommandLineFlagSecurityWarningsEnabled	Enable security warnings for command-line flags
ComponentUpdatesEnabled	Enable component updates in Google Chrome
ContextMenuPhotoSharingSettings	Allow saving images directly to Google Photos
ContextualGoogleIntegrationsConfiguration	Contextual integrations of Google services on Google ChromeOS
ContextualGoogleIntegrationsEnabled	Contextual integrations of Google services on Google ChromeOS
ContextualSearchEnabled	Enable Touch to Search
CreatePasskeysInICloudKeychain	Control whether passkey creation will default to iCloud Keychain.
CredentialProviderPromoEnabled	Allows users to be shown the Credential Provider Extension promo
DNSInterceptionChecksEnabled	DNS interception checks enabled
DataLeakPreventionClipboardCheckSizeLimit	Set minimal size limit for data leak prevention clipboard restriction
DataLeakPreventionReportingEnabled	Enable data leak prevention reporting
DataLeakPreventionRulesList	Sets a list of data leak prevention rules.
DefaultBrowserSettingEnabled	Set Google Chrome as Default Browser
DefaultDownloadDirectory	Set default download directory
DefaultHandlersForFileExtensions	Assigns apps as default handlers for specified file extensions
DefaultSearchProviderContextMenuAccessAllowed	Allow default search provider context menu search access
DeleteKeyModifier	Control the shortcut used to trigger the Delete "six pack" key
DesktopSharingHubEnabled	Enable desktop sharing in the omnibox and 3-dot menu
DevToolsGoogleDeveloperProgramProfileAvailability	Enable Google Developer Program Profiles in Chrome DevTools
DeveloperToolsAvailability	Control where Developer Tools can be used
DeveloperToolsDisabled	Disable Developer Tools
DeviceAllowBluetooth	Allow bluetooth on device
DeviceAllowEnterpriseRemoteAccessConnections	Allow enterprise remote access connections to this machine
DeviceAllowMGSToStoreDisplayProperties	Allow Managed guest session to persist display properties
DeviceAllowRedeemChromeOsRegistrationOffers	Allow users to redeem offers through Google ChromeOS Registration
DeviceAllowedBluetoothServices	Only allow connection to the Bluetooth services in the list
DeviceAuthenticationURLAllowlist	Allow access to a list of URLs during authentication
DeviceAuthenticationURLBlocklist	Block access to a list of URL patterns during authentication
DeviceBlockDevmode	Block developer mode
DeviceBluetoothJustWorksPairingEnabled	Enable "Just Works" Bluetooth pairing
DeviceChromeVariations	Determine the availability of variations on Google ChromeOS
DeviceDebugPacketCaptureAllowed	Allow debug network packet captures
DeviceDlcPredownloadList	Select DLCs (Downloadable Content) that need to be pre downloaded
DeviceEncryptedReportingPipelineEnabled	Enable the Encrypted Reporting Pipeline
DeviceEphemeralNetworkPoliciesEnabled	Controls the enablement of the EphemeralNetworkPolicies feature
DeviceHardwareVideoDecodingEnabled	Enable GPU hardware video decoding
DeviceI18nShortcutsEnabled	Allows enabling/disabling international shortcut keys remaps
DeviceKeyboardBacklightColor	Default keyboard backlight color
DeviceKeylockerForStorageEncryptionEnabled	Controls use of AES Keylocker for user storage encryption if supported
DeviceLoginScreenPrimaryMouseButtonSwitch	Switch the primary mouse button to the right button on the login screen
DeviceLoginScreenSecurityKeyPermitAttestation	URLs/domains automatically permitted direct Security Key attestation on the login screen
DeviceLoginScreenWebHidAllowDevicesForUrls	Automatically grant permission to these sites to connect to HID devices with the given vendor and product IDs on the login screen.
DeviceLoginScreenWebUsbAllowDevicesForUrls	Automatically grant permission to these sites to connect to USB devices with the given vendor and product IDs on the login screen.
DeviceOffHours	Off hours intervals when the specified device policies are released
DevicePciPeripheralDataAccessEnabled	Enable Thunderbolt/USB4 peripheral data access
DevicePolicyRefreshRate	Refresh rate for Device Policy
DevicePostQuantumKeyAgreementEnabled	Enable post-quantum key agreement for TLS for device
DevicePowerwashAllowed	Allow the device to request powerwash
DeviceQuirksDownloadEnabled	Enable queries to Quirks Server for hardware profiles
DeviceRebootOnUserSignout	Force device reboot when user sign out
DeviceReleaseLtsTag	Allow device to receive LTS updates
DeviceRestrictedManagedGuestSessionEnabled	Restricted managed guest sessions
DeviceRestrictionSchedule	Specifies weekly intervals when ChromeOS devices cannot be used
DeviceScheduledReboot	Set custom schedule to reboot devices
DeviceScheduledUpdateCheck	Set custom schedule to check for updates
DeviceShowLowDiskSpaceNotification	Show notification when disk space is low
DeviceSwitchFunctionKeysBehaviorEnabled	Controls the setting "Use the launcher/search key to change the behavior of function keys"
DeviceSystemWideTracingEnabled	Allow collection of system-wide performance trace
DeviceUserInitiatedFirmwareUpdatesEnabled	Allow users to initiate firmware updates
Disable3DAPIs	Disable support for 3D graphics APIs
DisableScreenshots	Disable taking screenshots
DisabledSchemes	Disable URL protocol schemes
DiskCacheDir	Set disk cache directory
DiskCacheSize	Set disk cache size in bytes
DnsOverHttpsMode	Controls the mode of DNS-over-HTTPS
DnsOverHttpsTemplates	Specify URI template of desired DNS-over-HTTPS resolver
DocumentScanAPITrustedExtensions	Extensions allowed to skip confirmation dialogs when accessing scanners via chrome.documentScan API
DomainReliabilityAllowed	Allow reporting of domain reliability related data
DownloadDirectory	Set download directory
DownloadManagerSaveToDriveSettings	Allow saving files directly to Google Drive
DownloadRestrictions	Allow download restrictions
DynamicCodeSettings	Dynamic Code Settings
EasyUnlockAllowed	Allow Smart Lock to be used
EcheAllowed	Allow Eche to be enabled.
EditBookmarksEnabled	Enable or disable bookmark editing
EmojiPickerGifSupportEnabled	GIF Support in Emoji Picker
EmojiSuggestionEnabled	Enable Emoji Suggestion
EnableExperimentalPolicies	Enables experimental policies
EnableOnlineRevocationChecks	Enable online OCSP/CRL checks
EnableSyncConsent	Enable displaying Sync Consent during sign-in
EnableUnsafeSwiftShader	Allow software WebGL fallback using SwiftShader
EncryptedClientHelloEnabled	Enable TLS Encrypted ClientHello
EnterpriseAuthenticationAppLinkPolicy	External authentication app launch URLs
EnterpriseCustomLabel	Set a custom enterprise label for a managed profile
EnterpriseCustomLabelForBrowser	Set a custom enterprise label for a managed browser
EnterpriseHardwarePlatformAPIEnabled	Enables managed extensions to use the Enterprise Hardware Platform API
EnterpriseLogoUrl	Enterprise Logo URL for a managed profile
EnterpriseLogoUrlForBrowser	Enterprise Logo URL for a managed browser
EnterpriseProfileBadgeToolbarSettings	Controls visibility of enterprise profile badge in the toolbar
EnterpriseProfileCreationKeepBrowsingData	Keep browsing data when creating enterprise profile by default
EnterpriseSearchAggregatorSettings	Enterprise search aggregator settings
EssentialSearchEnabled	Enable only essential cookies and data in search
ExemptDomainFileTypePairsFromFileTypeDownloadWarnings	Disable download file type extension-based warnings for specified file types on domains
ExplicitlyAllowedNetworkPorts	Explicitly allowed network ports
ExtensionCacheSize	Set Apps and Extensions cache size (in bytes)
ExternalProtocolDialogShowAlwaysOpenCheckbox	Show an "Always open" checkbox in external protocol dialog.
ExternalStorageAllowlist	External Storage Allowlist
ExternalStorageDisabled	Disable mounting of external storage
ExternalStorageReadOnly	Treat external storage devices as read-only
F11KeyModifier	Control the shortcut used to trigger F11
F12KeyModifier	Control the shortcut used to trigger F12
FastPairEnabled	Enable Fast Pair (fast Bluetooth pairing)
FeedbackSurveysEnabled	Specifies whether in-product Google Chrome surveys are shown to users.
FetchKeepaliveDurationSecondsOnShutdown	Fetch keepalive duration on Shutdown
FileOrDirectoryPickerWithoutGestureAllowedForOrigins	Allow file or directory picker APIs to be called without prior user gesture
FilePickerChooseFromDriveSettings	Allow choosing files directly from Google Drive
FloatingWorkspaceEnabled	Enable Floating Workspace Service
FloatingWorkspaceV2Enabled	Enable Google Chrome Service
FocusModeSoundsEnabled	Enable Sounds in Focus Mode for ChromeOS
ForceBrowserSignin	Enable force sign in for Google Chrome
ForceEphemeralProfiles	Ephemeral profile
ForceGoogleSafeSearch	Force Google SafeSearch
ForceMaximizeOnFirstRun	Maximize the first browser window on first run
ForcePermissionPolicyUnloadDefaultEnabled	Controls whether unload event handlers can be disabled.
ForceSafeSearch	Force SafeSearch
ForceYouTubeRestrict	Force minimum YouTube Restricted Mode
ForceYouTubeSafetyMode	Force YouTube Safety Mode
ForcedLanguages	Configure the content and order of preferred languages
FullRestoreEnabled	Enable the full restore feature
FullRestoreMode	Configure app restore on login
FullscreenAlertEnabled	Enable fullscreen alert
FullscreenAllowed	Allow fullscreen mode
GaiaLockScreenOfflineSigninTimeLimitDays	Limit the time for which a user authenticated via GAIA without SAML can log in offline at the lock screen
GhostWindowEnabled	Enable the ghost window feature
GloballyScopeHTTPAuthCacheEnabled	Enable globally scoped HTTP auth cache
GoogleSearchSidePanelEnabled	Enable Google Search Side Panel
HSTSPolicyBypassList	List of names that will bypass the HSTS policy check
HardwareAccelerationModeEnabled	Use graphics acceleration when available
HeadlessMode	Control use of the Headless Mode
HideWebStoreIcon	Hide the web store from the New Tab Page and app launcher
HighEfficiencyModeEnabled	Enable High Efficiency Mode
HistoryClustersVisible	Show a view of Chrome history with groups of pages
HomeAndEndKeysModifier	Control the shortcut used to trigger the Home/End "six pack" keys
HttpAllowlist	HTTP Allowlist
HttpsOnlyMode	Allow HTTPS-Only Mode to be enabled
HttpsUpgradesEnabled	Enable automatic HTTPS upgrades
ImportAutofillFormData	Import autofill form data from default browser on first run
ImportBookmarks	Import bookmarks from default browser on first run
ImportHistory	Import browsing history from default browser on first run
ImportHomepage	Import of homepage from default browser on first run
ImportSavedPasswords	Import saved passwords from default browser on first run
ImportSearchEngine	Import search engines from default browser on first run
IncognitoEnabled	Enable Incognito mode
IncognitoModeAvailability	Incognito mode availability
InsecureFormsWarningsEnabled	Enable warnings for insecure forms
InsertKeyModifier	Control the shortcut used to trigger the Insert "six pack" key
InsightsExtensionEnabled	Enable insights extension for reporting usage metrics
InstantTetheringAllowed	Allow Instant Tethering to be used.
IntensiveWakeUpThrottlingEnabled	Control the IntensiveWakeUpThrottling feature.
IntranetRedirectBehavior	Intranet Redirection Behavior
IsolateOrigins	Enable Site Isolation for specified origins
IsolateOriginsAndroid	Enable Site Isolation for specified origins on Android devices
IsolatedWebAppInstallForceList	Configure list of force-installed Isolated Web Apps
JavascriptEnabled	Enable JavaScript
KeepFullscreenWithoutNotificationUrlAllowList	List of URLs which are allowed to remain in full screen mode without showing a notification
KeyPermissions	Key Permissions
KioskBrowserPermissionsAllowedForOrigins	Allow origins to access browser permissions available to the web kiosk install origin.
LensCameraAssistedSearchEnabled	Allow Google Lens camera assisted search
LensDesktopNTPSearchEnabled	Allow Google Lens button to be shown in the search box on the New Tab page if supported.
LensOnGalleryEnabled	Enables the Lens / Gallery App integration on Google ChromeOS
LensOverlaySettings	Settings for the Lens Overlay feature
LensRegionSearchEnabled	Allow Google Lens region search menu item to be shown in context menu if supported.
ListenToThisPageEnabled	Enable read aloud (text distillation and text-to-speech synthesis) for web pages
LockScreenAutoStartOnlineReauth	Automatic start of online re-authentication on the lock screen
LockScreenMediaPlaybackEnabled	Allows users to play media when the device is locked
LoginDisplayPasswordButtonEnabled	Show the display password button on the login and lock screen
LookalikeWarningAllowlistDomains	Suppress lookalike domain warnings on domains
ManagedAccountsSigninRestriction	Add restrictions on managed accounts
ManagedBookmarks	Managed Bookmarks
ManagedConfigurationPerOrigin	Sets managed configuration values to websites to specific origins
ManagedGuestSessionPrivacyWarningsEnabled	Reduce Managed-guest session auto-launch notifications
MaxConnectionsPerProxy	Maximal number of concurrent connections to the proxy server
MaxInvalidationFetchDelay	Maximum fetch delay after a policy invalidation
MediaRecommendationsEnabled	Enable Media Recommendations
MemorySaverModeSavings	Change Memory Saver Mode Savings
MetricsReportingEnabled	Enable reporting of usage and crash-related data
NTPCardsVisible	Show cards on the New Tab Page
NTPContentSuggestionsEnabled	Show content suggestions on the New Tab page
NTPCustomBackgroundEnabled	Allow users to customize the background on the New Tab page
NTPFooterExtensionAttributionEnabled	Control the visibility of the extension attribution on the New Tab page
NTPFooterManagementNoticeEnabled	Control the visibility of the management notice on the New Tab Page for managed browsers
NTPMiddleSlotAnnouncementVisible	Show the middle slot announcement on the New Tab Page
NTPOutlookCardVisible	Show Outlook Calendar card on the New Tab Page
NTPSharepointCardVisible	Show SharePoint and OneDrive File Card on the New Tab Page
NTPShortcuts	Setting shortcuts on the New Tab Page (Beta)
NativeHostsExecutablesLaunchDirectly	Force Windows executable Native Messaging hosts to launch directly
NearbyShareAllowed	Allow Nearby Share to be enabled.
NetworkPredictionOptions	Enable network prediction
NetworkServiceSandboxEnabled	Enable the network service sandbox
NoteTakingAppsLockScreenAllowlist	The list of note-taking apps allowed on the Google ChromeOS lock screen
OpenNetworkConfiguration	User-level network configuration
OrcaEnabled	Control the enablement of ChromeOS "Help me write" feature
OriginAgentClusterDefaultEnabled	Allows origin-keyed agent clustering by default.
OriginKeyedProcessesEnabled	Enable origin-keyed process isolation by default.
OsColorMode	ChromeOS color mode
OverrideSecurityRestrictionsOnInsecureOrigin	Origins or hostname patterns for which restrictions on insecure origins should not apply
PageUpAndPageDownKeysModifier	Control the shortcut used to trigger the PageUp/PageDown "six pack" keys
PaymentMethodQueryEnabled	Allow websites to query for available payment methods.
PdfAnnotationsEnabled	Enable PDF Annotations
PdfUseSkiaRendererEnabled	Use Skia renderer for PDF rendering
PdfViewerOutOfProcessIframeEnabled	Use out-of-process iframe PDF Viewer
PhoneHubAllowed	Allow Phone Hub to be enabled.
PhoneHubCameraRollAllowed	Allow recent photos and videos taken on the phone to be accessed via Phone Hub.
PhoneHubNotificationsAllowed	Allow Phone Hub notifications to be enabled.
PhoneHubTaskContinuationAllowed	Allow Phone Hub task continuation to be enabled.
PhysicalKeyboardAutocorrect	Control the autocorrect feature on the physical keyboard
PhysicalKeyboardPredictiveWriting	Control the predictive writing feature on the physical keyboard
PinnedLauncherApps	List of pinned apps to show in the launcher
PolicyAtomicGroupsEnabled	Enables the concept of policy atomic groups
PolicyDictionaryMultipleSourceMergeList	Allow merging dictionary policies from different sources
PolicyListMultipleSourceMergeList	Allow merging list policies from different sources
PolicyRefreshRate	Refresh rate for user policy
PostQuantumKeyAgreementEnabled	Enable post-quantum key agreement for TLS
PrefetchWithServiceWorkerEnabled	Allow SpeculationRules prefetch to ServiceWorker-controlled URLs
PrimaryMouseButtonSwitch	Switch the primary mouse button to the right button
ProfilePickerOnStartupAvailability	Profile picker availability on startup
ProfileReauthPrompt	Prompt users to re-authenticate to the profile
PromotionalTabsEnabled	Enable showing full-tab promotional content
PromotionsEnabled	Enable showing promotional content
PromptForDownloadLocation	Ask where to save each file before downloading
PromptOnMultipleMatchingCertificates	Prompt when multiple certificates match
ProvisionalNotificationsAllowed	Allows the app to use provisional notification authorization on iOS
ProxySettings	Proxy settings
QRCodeGeneratorEnabled	Enable QR Code Generator
QuicAllowed	Allow QUIC protocol
QuickOfficeForceFileDownloadEnabled	Force downloading of Office documents (e.g. .docx) instead of opening them in the Basic Editor
ReduceAcceptLanguageEnabled	Control Accept-Language Reduction
RelaunchFastIfOutdated	Relaunch fast if outdated
RelaunchHeadsUpPeriod	Set the time of the first user relaunch notification
RelaunchNotification	Notify a user that a browser relaunch or device restart is recommended or required
RelaunchNotificationPeriod	Set the time period for update notifications
RelaunchWindow	Set the time interval for relaunch
RemoteDebuggingAllowed	Allow remote debugging
RendererAppContainerEnabled	Enable Renderer App Container
ReportCrostiniUsageEnabled	Report information about usage of Linux apps
RequireOnlineRevocationChecksForLocalAnchors	Require online OCSP/CRL checks for local trust anchors
RestrictAccountsToPatterns	Restrict accounts that are visible in Google Chrome
RestrictCoreSharingOnRenderer	Restrict CPU core sharing for renderer process
RestrictSigninToPattern	Restrict which Google accounts are allowed to be set as browser primary accounts in Google Chrome
RestrictedManagedGuestSessionExtensionCleanupExemptList	Configure the list of extension IDs exempt from the restricted managed guest session clean-up procedure
RoamingProfileLocation	Set the roaming profile directory
RoamingProfileSupportEnabled	Enable the creation of roaming copies for Google Chrome profile data
SSLErrorOverrideAllowed	Allow proceeding from the SSL warning page
SSLErrorOverrideAllowedForOrigins	Allow proceeding from the SSL warning page on specific origins
SafeBrowsingForTrustedSourcesEnabled	Enable Safe Browsing for trusted sources
SafeSitesFilterBehavior	Control SafeSites adult content filtering.
SamlLockScreenOfflineSigninTimeLimitDays	Limit the time for which a user authenticated via SAML can log in offline at the lock screen
SandboxExternalProtocolBlocked	Allow Chrome to block navigations toward external protocols in sandboxed iframes
SavingBrowserHistoryDisabled	Disable saving browser history
SchedulerConfiguration	Select task scheduler configuration
ScreenCaptureLocation	Set location to store screen captures
ScreenCaptureWithoutGestureAllowedForOrigins	Allow screen capture without prior user gesture
ScrollToTextFragmentEnabled	Enable scrolling to text specified in URL fragments
SearchSuggestEnabled	Enable search suggestions
SecondaryGoogleAccountSigninAllowed	Allow Sign-in To Additional Google Accounts
SecurityKeyPermitAttestation	URLs/domains automatically permitted direct Security Key attestation
SecurityTokenSessionBehavior	Action on security token removal (e.g., smart card) for Google ChromeOS.
SecurityTokenSessionNotificationSeconds	Duration of the notification on smart card removal for Google ChromeOS.
ServiceWorkerAutoPreloadEnabled	Allow ServiceWorker to dispatch navigation requests without waiting for its startup
ServiceWorkerToControlSrcdocIframeEnabled	Allow ServiceWorker to control srcdoc iframes
SessionLengthLimit	Limit the length of a user session
SessionLocales	Set the recommended locales for a managed session
SharedArrayBufferUnrestrictedAccessAllowed	Specifies whether SharedArrayBuffers can be used in a non cross-origin-isolated context
SharedClipboardEnabled	Enable the Shared Clipboard Feature
SharedWorkerBlobURLFixEnabled	Make SharedWorker blob URL behavior aligned with the specification
ShelfAlignment	Control the shelf position
ShelfAutoHideBehavior	Control shelf auto-hiding
ShoppingListEnabled	Allow the shopping list feature to be enabled
ShortcutCustomizationAllowed	Allow customization of system shortcuts
ShowAiIntroScreenEnabled	Enable displaying the introduction screen for in-session AI features during sign-in flow
ShowAppsShortcutInBookmarkBar	Show the apps shortcut in the bookmark bar
ShowDisplaySizeScreenEnabled	Enable displaying display size setting screen during sign-in
ShowFullUrlsInAddressBar	Show Full URLs
ShowGeminiIntroScreenEnabled	Enable displaying the introduction screen for Gemini during sign-in flow
ShowLogoutButtonInTray	Add a logout button to the system tray
ShowTouchpadScrollScreenEnabled	Enable displaying touchpad scrolling direction screen during sign-in
SideSearchEnabled	Allow showing the most recent default search engine results page in a Browser side panel
SignedHTTPExchangeEnabled	Enable Signed HTTP Exchange (SXG) support
SigninAllowed	Allow sign in to Google Chrome
SigninInterceptionEnabled	Enable signin interception
SitePerProcess	Require Site Isolation for every site
SitePerProcessAndroid	Enable Site Isolation for every site
SiteSearchSettings	Site search settings
SmsMessagesAllowed	Allow SMS Messages to be synced from phone to Chromebook.
SpellCheckServiceEnabled	Enable or disable spell checking web service
SpellcheckEnabled	Enable spellcheck
SpellcheckLanguage	Force enable spellcheck languages
SpellcheckLanguageBlocklist	Force disable spellcheck languages
StandardizedBrowserZoomEnabled	Enable Standardized Browser Zoom Behavior
StartupBrowserWindowLaunchSuppressed	Suppress launching of browser window
StrictMimetypeCheckForWorkerScriptsEnabled	Enable strict MIME type checking for worker scripts
SubAppsAPIsAllowedWithoutGestureAndAuthorizationForOrigins	Allow subApps APIs to be called without prior user gesture or requiring user confirmation.
SuggestLogoutAfterClosingLastWindow	Display the logout confirmation dialog
SuggestedContentEnabled	Enable Suggested Content
SuppressDifferentOriginSubframeDialogs	Suppress JavaScript Dialogs triggered from different origin subframes
SuppressUnsupportedOSWarning	Suppress the unsupported OS warning
SyncDisabled	Disable synchronization of data with Google
SyncTypesListDisabled	List of types that should be excluded from synchronization
SystemFeaturesDisableList	Configure the camera, browser settings, os settings, scanning, web store, canvas, explore, crosh, gallery, terminal, recorder, print jobs, key_shortcuts, gmail, google_docs, google_slides, google_sheets, google_drive, google_keep, google_calendar, google_chat, youtube, google_maps, calculator and text_editor features to be disabled
SystemFeaturesDisableMode	Set the user experience of disabled features
SystemProxySettings	Configures System-proxy service for Google ChromeOS.
SystemShortcutBehavior	Allows applications to capture and override default system shortcuts.
TLS13EarlyDataEnabled	Enable TLS 1.3 Early Data
TPMFirmwareUpdateSettings	Configure TPM firmware update behavior
TabDiscardingExceptions	URL pattern Exceptions to tab discarding
TaskManagerEndProcessEnabled	Enable ending processes in Task Manager
TermsOfServiceURL	Set the Terms of Service for a device-local account
TosDialogBehavior	Configuring the ToS behavior during first-run for CCT
TotalMemoryLimitMb	Set limit on megabytes of memory a single Chrome instance can use.
TouchVirtualKeyboardEnabled	Enable the touch virtual keyboard
TranslateEnabled	Enable Translate
TranslatorAPIAllowed	Allow Translator API
TrashEnabled	Enable capability to send files to the Trash (on supported filesystems) in the Google ChromeOS Files app
URLAllowlist	Allow access to a list of URLs
URLBlocklist	Block access to a list of URLs
UnifiedDesktopEnabledByDefault	Make Unified Desktop available and turn on by default
UnsafelyTreatInsecureOriginAsSecure	Origins or hostname patterns for which restrictions on insecure origins should not apply
UrlKeyedAnonymizedDataCollectionEnabled	Enable URL-keyed anonymized data collection
UsbDetachableAllowlist	Allowlist of USB detachable devices
UsbDetectorNotificationEnabled	Show a notification when a USB device is detected
UserAgentReduction	Enable or disable the User-Agent Reduction.
UserAvatarCustomizationSelectorsEnabled	Allow customization of user avatar image using Google profile image or local images.
UserAvatarImage	User avatar image
UserDataDir	Set user data directory
UserDataSnapshotRetentionLimit	Limits the number of user data snapshots retained for use in case of emergency rollback.
UserDisplayName	Set the display name for device-local accounts
UserFeedbackAllowed	Allow user feedback
VideoCaptureAllowed	Allow or deny video capture
VideoCaptureAllowedUrls	URLs that will be granted access to video capture devices without prompt
VirtualKeyboardResizesLayoutByDefault	The virtual keyboard resizes the layout viewport by default
VirtualKeyboardSmartVisibilityEnabled	Let the on-screen keyboard appear when appropriate.
VmManagementCliAllowed	Specify VM CLI permission
VpnConfigAllowed	Allow the user to manage VPN connections
WPADQuickCheckEnabled	Enable WPAD optimization
WallpaperGooglePhotosIntegrationEnabled	Wallpaper selection from Google Photos
WallpaperImage	Wallpaper image
WarnBeforeQuittingEnabled	Show a warning dialog when the user is attempting to quit
WebAnnotations	Allow detecting plain text entities in web pages.
WebAppInstallForceList	Configure list of force-installed Web Apps
WebAppSettings	Web App management settings
WebAudioOutputBufferingEnabled	Enable adaptive buffering for Web Audio
WebAuthenticationRemoteDesktopAllowedOrigins	Allowed Origins for Proxied WebAuthn Requests from Remote Desktop Applications.
WebAuthnFactors	Configure allowed WebAuthn factors
WebRtcEventLogCollectionAllowed	Allow collection of WebRTC event logs from Google services
WebRtcLocalIpsAllowedUrls	URLs for which local IPs are exposed in WebRTC ICE candidates
WebRtcTextLogCollectionAllowed	Allow WebRTC text logs collection from Google Services
WebRtcUdpPortRange	Restrict the range of local UDP ports used by WebRTC
WebXRImmersiveArEnabled	Allow creating WebXR's "immersive-ar" sessions
WifiSyncAndroidAllowed	Allow Wi-Fi network configurations to be synced across Google ChromeOS devices and a connected Android phone.
WindowOcclusionEnabled	Enable Window Occlusion
Native Messaging
NativeMessagingAllowlist	Configure native messaging allowlist
NativeMessagingBlocklist	Configure native messaging blocklist
NativeMessagingUserLevelHosts	Allow user-level Native Messaging hosts (installed without admin permissions)
Network File Shares settings
NTLMShareAuthenticationEnabled	Controls enabling NTLM as an authentication protocol for SMB mounts
NetBiosShareDiscoveryEnabled	Controls Network File Share discovery via NetBIOS
NetworkFileSharesAllowed	Controls Network File Shares for ChromeOS availability
NetworkFileSharesPreconfiguredShares	List of preconfigured network file shares.
Network settings
AccessControlAllowMethodsInCORSPreflightSpecConformant	Make Access-Control-Allow-Methods matching in CORS preflight spec conformant
CompressionDictionaryTransportEnabled	Enable compression dictionary transport support
DataURLWhitespacePreservationEnabled	DataURL Whitespace Preservation for all media types
DeviceDataRoamingEnabled	Enable data roaming
DeviceDockMacAddressSource	Device MAC address source when docked
DeviceHostnameTemplate	Device network hostname template
DeviceHostnameUserConfigurable	Allow user to configure their device hostname
DeviceOpenNetworkConfiguration	Device-level network configuration
DeviceWiFiAllowed	Enable WiFi
DeviceWiFiFastTransitionEnabled	Enable 802.11r Fast Transition
DnsOverHttpsExcludedDomains	Specify domains to be excluded from being resolved using DNS-over-HTTPS
DnsOverHttpsIncludedDomains	Specify domains to be resolved using DNS-over-HTTPS
DnsOverHttpsSalt	Specify a salt value to be used in DnsOverHttpsTemplatesWithIdentifiers when evaluating identity information
DnsOverHttpsTemplatesWithIdentifiers	Specify URI template of desired DNS-over-HTTPS resolver with identity information
HappyEyeballsV3Enabled	Use the Happy Eyeballs V3 algorithm
IPv6ReachabilityOverrideEnabled	Enable IPv6 reachability check override
NetworkThrottlingEnabled	Enable throttling network bandwidth
OutOfProcessSystemDnsResolutionEnabled	Enable system DNS resolution outside of the network service
Parental supervision settings
EduCoexistenceToSVersion	The valid version of Edu Coexistence Terms of Service
ParentAccessCodeConfig	Parent Access Code Configuration
PerAppTimeLimits	Per-App Time Limits
PerAppTimeLimitsAllowlist	Per-App Time Limits Allowlist
UsageTimeLimit	Time Limit
Password manager
AutomatedPasswordChangeSettings	Enable automated password change
DeletingUndecryptablePasswordsEnabled	Enable deleting undecryptable passwords
PasswordDismissCompromisedAlertEnabled	Enable dismissing compromised password alerts for entered credentials
PasswordLeakDetectionEnabled	Enable leak detection for entered credentials
PasswordManagerBlocklist	Configure the list of domains for which the Password Manager (Save and Fill) will be disabled
PasswordManagerEnabled	Enable saving passwords to the password manager
PasswordManagerPasskeysEnabled	Enable saving passkeys to the password manager
PasswordSharingEnabled	Enable sharing user credentials with other users
ThirdPartyPasswordManagersAllowed	Allow using Third-Party Password Managers in Google Chrome on Android
PluginVm
PluginVmAllowed	Allow devices to use a PluginVm on Google ChromeOS
PluginVmDataCollectionAllowed	Allow PluginVm Product Analytics
PluginVmImage	PluginVm image
PluginVmRequiredFreeDiskSpace	Required free disk space for PluginVm
PluginVmUserId	PluginVm user id
UserPluginVmAllowed	Allow users to use a PluginVm on Google ChromeOS
Power and shutdown
DeviceLoginScreenPowerManagement	Power management on the login screen
DeviceRebootOnShutdown	Automatic reboot on device shutdown
UptimeLimit	Limit device uptime by automatically rebooting
Power management
AllowScreenWakeLocks	Allow screen wake locks
AllowWakeLocks	Allow wake locks
DeviceAdvancedBatteryChargeModeDayConfig	Set advanced battery charge mode day config
DeviceAdvancedBatteryChargeModeEnabled	Enable advanced battery charge mode
DeviceBatteryChargeCustomStartCharging	Set battery charge custom start charging in percent
DeviceBatteryChargeCustomStopCharging	Set battery charge custom stop charging in percent
DeviceBatteryChargeMode	Battery charge mode
DeviceBootOnAcEnabled	Enable boot on AC (alternating current)
DeviceChargingSoundsEnabled	Enable Charging Sounds
DeviceLowBatterySoundEnabled	Enable Low Battery Sound
DevicePowerAdaptiveChargingEnabled	Enable adaptive charging model to hold charging process to extend battery life
DevicePowerBatteryChargingOptimization	Battery Charging Optimization
DevicePowerPeakShiftBatteryThreshold	Set power peak shift battery threshold in percent
DevicePowerPeakShiftDayConfig	Set power peak shift day config
DevicePowerPeakShiftEnabled	Enable peak shift power management
DeviceUsbPowerShareEnabled	Enable USB power share
IdleAction	Action to take when the idle delay is reached
IdleActionAC	Action to take when the idle delay is reached while running on AC power
IdleActionBattery	Action to take when the idle delay is reached while running on battery power
IdleDelayAC	Idle delay when running on AC power
IdleDelayBattery	Idle delay when running on battery power
IdleWarningDelayAC	Idle warning delay when running on AC power
IdleWarningDelayBattery	Idle warning delay when running on battery power
LidCloseAction	Action to take when the user closes the lid
PowerManagementIdleSettings	Power management settings when the user becomes idle
PowerManagementUsesAudioActivity	Specify whether audio activity affects power management
PowerManagementUsesVideoActivity	Specify whether video activity affects power management
PowerSmartDimEnabled	Enable smart dim model to extend the time until the screen is dimmed
PresentationScreenDimDelayScale	Percentage by which to scale the screen dim delay in presentation mode
ScreenBrightnessPercent	Screen brightness percent
ScreenDimDelayAC	Screen dim delay when running on AC power
ScreenDimDelayBattery	Screen dim delay when running on battery power
ScreenLockDelayAC	Screen lock delay when running on AC power
ScreenLockDelayBattery	Screen lock delay when running on battery power
ScreenLockDelays	Screen lock delays
ScreenOffDelayAC	Screen off delay when running on AC power
ScreenOffDelayBattery	Screen off delay when running on battery power
UserActivityScreenDimDelayScale	Percentage by which to scale the screen dim delay if the user becomes active after dimming
WaitForInitialUserActivity	Wait for initial user activity
Printing
CloudPrintProxyEnabled	Enable Google Cloud Print proxy
DefaultPrinterSelection	Default printer selection rules
DeletePrintJobHistoryAllowed	Allow print job history to be deleted
DeviceExternalPrintServers	External print servers
DeviceExternalPrintServersAllowlist	Enabled external print servers
DevicePrinters	Enterprise printer configuration file for devices
DevicePrintersAccessMode	Device printers configuration access policy.
DevicePrintersAllowlist	Enabled enterprise device printers
DevicePrintersBlocklist	Disabled enterprise device printers
DevicePrintingClientNameTemplate	Template for the 'client-name' Internet Printing Protocol attribute
DisablePrintPreview	Disable Print Preview
ExternalPrintServers	External print servers
ExternalPrintServersAllowlist	Enabled external print servers
OopPrintDriversAllowed	Out-of-process print drivers allowed
PrintHeaderFooter	Print Headers and Footers
PrintJobHistoryExpirationPeriod	Set the time period in days for storing print jobs metadata
PrintPdfAsImageAvailability	Print PDF as Image Available
PrintPdfAsImageDefault	Print PDF as Image Default
PrintPostScriptMode	Print PostScript Mode
PrintPreviewUseSystemDefaultPrinter	Use System Default Printer as Default
PrintRasterizationMode	Print Rasterization Mode
PrintRasterizePdfDpi	Print Rasterize PDF DPI
PrinterTypeDenyList	Disable printer types on the deny list
Printers	Configures a list of printers
PrintersBulkAccessMode	Printer configuration access policy.
PrintersBulkAllowlist	Enabled enterprise printers
PrintersBulkBlocklist	Disabled enterprise printers
PrintersBulkConfiguration	Enterprise printer configuration file
PrintingAPIExtensionsAllowlist	Extensions allowed to skip confirmation dialog when sending print jobs via chrome.printing API
PrintingAllowedBackgroundGraphicsModes	Restrict background graphics printing mode
PrintingAllowedColorModes	Restrict printing color mode
PrintingAllowedDuplexModes	Restrict printing duplex mode
PrintingAllowedPinModes	Restrict PIN printing mode
PrintingBackgroundGraphicsDefault	Default background graphics printing mode
PrintingColorDefault	Default printing color mode
PrintingDuplexDefault	Default printing duplex mode
PrintingEnabled	Enable printing
PrintingLPACSandboxEnabled	Enable Printing LPAC Sandbox
PrintingMaxSheetsAllowed	Maximal number of sheets allowed to use for a single print job
PrintingPaperSizeDefault	Default printing page size
PrintingPinDefault	Default PIN printing mode
PrintingSendUsernameAndFilenameEnabled	Send username and filename to native printers
UserPrintersAllowed	Allow access to CUPS printers
Privacy Sandbox policies
PrivacySandboxAdMeasurementEnabled	Choose whether the Privacy Sandbox ad measurement setting can be disabled
PrivacySandboxAdTopicsEnabled	Choose whether the Privacy Sandbox Ad topics setting can be disabled
PrivacySandboxFingerprintingProtectionEnabled	Choose whether the Privacy Sandbox Fingerprinting Protection feature is to be enabled in Incognito mode.
PrivacySandboxIpProtectionEnabled	Choose whether the Privacy Sandbox IP Protection feature should be enabled.
PrivacySandboxPromptEnabled	Choose whether the Privacy Sandbox prompt can be shown to your users
PrivacySandboxSiteEnabledAdsEnabled	Choose whether the Privacy Sandbox Site-suggested ads setting can be disabled
Privacy screen settings
DeviceLoginScreenPrivacyScreenEnabled	Set the state of privacy screen on the login screen
PrivacyScreenEnabled	Enable privacy screen
Protected Content
ProtectedContentIdentifiersAllowed	Allows web pages to use identifiers for the purpose of protected content playback
Proxy server
ProxyBypassList	Proxy bypass rules
ProxyMode	Choose how to specify proxy server settings
ProxyPacUrl	URL to a proxy .pac file
ProxyServer	Address or URL of proxy server
ProxyServerMode	Choose how to specify proxy server settings
Quick Answers
QuickAnswersDefinitionEnabled	Enable Quick Answers Definition
QuickAnswersEnabled	Enable Quick Answers
QuickAnswersTranslationEnabled	Enable Quick Answers Translation
QuickAnswersUnitConversionEnabled	Enable Quick Answers Unit Conversion
Quick unlock
PinUnlockAutosubmitEnabled	Enable PIN auto-submit feature on the lock and login screen.
PinUnlockMaximumLength	Set the maximum length of the lock screen PIN
PinUnlockMinimumLength	Set the minimum length of the lock screen PIN
PinUnlockWeakPinsAllowed	Enable users to set weak PINs for the lock screen PIN
QuickUnlockModeAllowlist	Configure allowed quick unlock modes
QuickUnlockTimeout	Set how often user has to enter password to use quick unlock
Related Website Sets Settings
RelatedWebsiteSetsEnabled	Enable Related Website Sets
RelatedWebsiteSetsOverrides	Override Related Website Sets.
Remote access
RemoteAccessHostAllowClientPairing	Enable or disable PIN-less authentication for remote access hosts
RemoteAccessHostAllowEnterpriseFileTransfer	Enable file transfer capability in enterprise remote support sessions
RemoteAccessHostAllowEnterpriseRemoteSupportConnections	Allow enterprise remote support connections to this machine
RemoteAccessHostAllowFileTransfer	Allow remote access users to transfer files to/from the host
RemoteAccessHostAllowPinAuthentication	Allow PIN and pairing authentication methods for remote access hosts
RemoteAccessHostAllowRelayedConnection	Enable the use of relay servers by the remote access host
RemoteAccessHostAllowRemoteAccessConnections	Allow remote access connections to this machine
RemoteAccessHostAllowRemoteSupportConnections	Allow remote support connections to this machine
RemoteAccessHostAllowUiAccessForRemoteAssistance	Allow remote users to interact with elevated windows in remote assistance sessions
RemoteAccessHostAllowUrlForwarding	Allow remote access users to open host-side URLs in their local client browser
RemoteAccessHostClientDomain	Configure the required domain name for remote access clients
RemoteAccessHostClientDomainList	Configure the required domain names for remote access clients
RemoteAccessHostClipboardSizeBytes	The maximum size, in bytes, that can be transferred between client and host via clipboard synchronization
RemoteAccessHostDomain	Configure the required domain name for remote access hosts
RemoteAccessHostDomainList	Configure the required domain names for remote access hosts
RemoteAccessHostFirewallTraversal	Enable firewall traversal from remote access host
RemoteAccessHostMatchUsername	Require that the name of the local user and the remote access host owner match
RemoteAccessHostMaximumSessionDurationMinutes	Maximum session duration allowed for remote access connections
RemoteAccessHostRequireCurtain	Enable curtaining of remote access hosts
RemoteAccessHostUdpPortRange	Restrict the UDP port range used by the remote access host
Remote attestation
AttestationExtensionAllowlist	Extensions allowed to to use the remote attestation API
AttestationForContentProtectionEnabled	Enable the use of remote attestation for content protection for the device
DeviceWebBasedAttestationAllowedUrls	URLs that will be granted access to perform the device attestation during SAML authentication
Safe Browsing settings
DisableSafeBrowsingProceedAnyway	Disable proceeding from the Safe Browsing warning page
PasswordProtectionChangePasswordURL	Configure the change password URL.
PasswordProtectionLoginURLs	Configure the list of enterprise login URLs where password protection service should capture salted hashes of passwords.
PasswordProtectionWarningTrigger	Password protection warning trigger
SafeBrowsingAllowlistDomains	Configure the list of domains on which Safe Browsing will not trigger warnings.
SafeBrowsingDeepScanningEnabled	Allow download deep scanning for Safe Browsing-enabled users
SafeBrowsingEnabled	Enable Safe Browsing
SafeBrowsingExtendedReportingEnabled	Enable Safe Browsing Extended Reporting
SafeBrowsingProtectionLevel	Safe Browsing Protection Level
SafeBrowsingProxiedRealTimeChecksAllowed	Allow Safe Browsing Proxied Real Time Checks
SafeBrowsingSurveysEnabled	Allow Safe Browsing Surveys
Saml user identity management settings
LockScreenReauthenticationEnabled	Enables online re-authentication on lock screen for SAML users
SAMLOfflineSigninTimeLimit	Limit the time for which a user authenticated via SAML can log in offline
SamlInSessionPasswordChangeEnabled	Password synchronization between third-party SSO providers and Chrome devices
SamlPasswordExpirationAdvanceWarningDays	How many days in advance to notify SAML users when their password is due to expire
Screencast
ProjectorDogfoodForFamilyLinkEnabled	Enable Screencast dogfood for Family Link users
ProjectorEnabled	Enable Screencast
Screensaver Settings
DeviceScreensaverLoginScreenEnabled	Device screensaver login screen enabled.
DeviceScreensaverLoginScreenIdleTimeoutSeconds	Device screensaver login screen idle timeout.
DeviceScreensaverLoginScreenImageDisplayIntervalSeconds	Device screensaver login screen image display interval.
DeviceScreensaverLoginScreenImages	Device screensaver login screen image source.
ScreensaverLockScreenEnabled	User screensaver lock screen enabled.
ScreensaverLockScreenIdleTimeoutSeconds	User screensaver lock screen idle timeout.
ScreensaverLockScreenImageDisplayIntervalSeconds	User screensaver lock screen image display interval.
ScreensaverLockScreenImages	User screensaver lock screen image source.
Sign-in settings
BoundSessionCredentialsEnabled	Bind Google credentials to a device
DeviceAllowNewUsers	Allow creation of new user accounts
DeviceAuthenticationFlowAutoReloadInterval	Automatically reload authentication flow on ChromeOS
DeviceAutofillSAMLUsername	Autofill username on SAML IdP page
DeviceEphemeralUsersEnabled	Wipe user data on sign-out
DeviceFamilyLinkAccountsAllowed	Allow addition of Family Link accounts to the device
DeviceGuestModeEnabled	Enable guest mode
DeviceLoginScreenAutoSelectCertificateForUrls	Automatically select client certificates for these sites on the sign-in screen
DeviceLoginScreenDomainAutoComplete	Enable domain name autocomplete during user sign in
DeviceLoginScreenExtensions	Configure the list of installed apps and extensions on the login screen
DeviceLoginScreenInputMethods	Device sign-in screen keyboard layouts
DeviceLoginScreenLocales	Device sign-in screen locale
DeviceLoginScreenPromptOnMultipleMatchingCertificates	Prompt when multiple certificates match on the sign-in screen
DeviceLoginScreenSystemInfoEnforced	Force the sign-in screen to show or hide system information.
DeviceRunAutomaticCleanupOnLogin	Control automatic cleanup during login
DeviceSecondFactorAuthentication	Integrated second factor authentication mode
DeviceShowNumericKeyboardForPassword	Show numeric keyboard for password
DeviceShowUserNamesOnSignin	Show usernames on login screen
DeviceTransferSAMLCookies	Transfer SAML IdP cookies during login
DeviceUserAllowlist	Login user allow list
DeviceWallpaperImage	Device wallpaper image
ExtensibleEnterpriseSSOBlocklist	Blocklist of identity providers that cannot use Extensible Enterprise SSO for the browser
LoginAuthenticationBehavior	Configure the login authentication behavior
LoginVideoCaptureAllowedUrls	URLs that will be granted access to video capture devices on SAML login pages
ProfileSeparationDomainExceptionList	Enterprise profile separation secondary domain allowlist
RecoveryFactorBehavior	Account recovery
Startup, Home page and New Tab page
HomepageIsNewTabPage	Use New Tab Page as homepage
HomepageLocation	Configure the home page URL
NewTabPageLocation	Configure the New Tab page URL
RestoreOnStartup	Action on startup
RestoreOnStartupURLs	URLs to open on startup
ShowHomeButton	Show Home button on toolbar
User and device reporting
DeviceActivityHeartbeatEnabled	Enable device activity heartbeat reporting
DeviceExtensionsSystemLogEnabled	Enable extensions system logging
DeviceFlexHwDataForProductImprovementEnabled	Send hardware data to Google to support improvements to ChromeOS Flex
DeviceMetricsReportingEnabled	Enable metrics reporting
DeviceReportNetworkEvents	Report network events
DeviceReportRuntimeCounters	Report device runtime counters
DeviceReportXDREvents	Report extended detection and response (XDR) events
HeartbeatEnabled	Send network packets to the management server to monitor online status
HeartbeatFrequency	Frequency of monitoring network packets
LogUploadEnabled	Send system logs to the management server
ReportAppInventory	App inventory reporting
ReportAppUsage	App usage reporting
ReportArcStatusEnabled	Report information about status of Android
ReportCRDSessions	Report CRD sessions
ReportDeviceActivityTimes	Report device activity times
ReportDeviceAppInfo	Report applications information
ReportDeviceAudioStatus	Report device audio status
ReportDeviceBacklightInfo	Report backlight info
ReportDeviceBluetoothInfo	Report Bluetooth info
ReportDeviceBoardStatus	Report board status
ReportDeviceBootMode	Report device boot mode
ReportDeviceCpuInfo	Report CPU info
ReportDeviceCrashReportInfo	Report information about crash reports.
ReportDeviceFanInfo	Report fan info
ReportDeviceGraphicsStatus	Report display and graphics statuses
ReportDeviceHardwareStatus	Report hardware status
ReportDeviceLoginLogout	Report login/logout
ReportDeviceMemoryInfo	Report memory info
ReportDeviceNetworkConfiguration	Report network configuration
ReportDeviceNetworkInterfaces	Report device network interfaces
ReportDeviceNetworkStatus	Report network status
ReportDeviceOsUpdateStatus	Report OS update status
ReportDevicePeripherals	Report peripheral details
ReportDevicePowerStatus	Report power status
ReportDevicePrintJobs	Report print jobs
ReportDeviceSecurityStatus	Report device security status
ReportDeviceSessionStatus	Report information about active kiosk sessions
ReportDeviceStorageStatus	Report storage status
ReportDeviceSystemInfo	Report system info
ReportDeviceTimezoneInfo	Report Timezone info
ReportDeviceUsers	Report device users
ReportDeviceVersionInfo	Report OS and firmware version
ReportDeviceVpdInfo	Report VPD info
ReportUploadFrequency	Frequency of device status report uploads
ReportWebsiteActivityAllowlist	Website activity reporting allowlist
ReportWebsiteTelemetry	Website telemetry reporting
ReportWebsiteTelemetryAllowlist	Website telemetry reporting allowlist
WebRtc settings
WebRtcIPHandling	WebRTC IP handling
WebRtcIPHandlingUrl	WebRTC per URL IP Handling
WebRtcPostQuantumKeyAgreement	Enable post-quantum key agreement for WebRTC
